NO textures/mehdi.xpm
SO textures/mehdi.xpm
				WE textures/mehdi.xpm
EA textures/mehdi.xpm

F 0, 0, 0
C 0, 0, 0

111111111111111111111111111111
 100000100000011100000100000011
 10000010000001 10000010000001 
 100111100100011100111100100011
 10001010000000000001010000N011
 100001100000000000001100000011
 100000100000000000000100000011
 100000000000000000000000000011
 100000100000011100000100000011
 100000100000000000000100000011
 100000000000000000000000000011
 100000100000011100000100000011
 111111111111111111111111111111
