NO textures/wall.xpm
SO textures/wall.xpm
WE textures/wall.xpm
EA textures/wall.xpm


F 10, 0, 30
C 2, 1, 10

111111111111111111111111111111111
10000010000000011 1000011110001
10000010000000011 1000011110001
10011110010000011 1000011110001
10001010000000011 1000011110001
10000110000000011 1000011110001
1000W00100000000110000001100001
1000000000000000000000001100001
1111111000000000000000001100001
1000000100000000000000001100001
1000000000011000110000001100001
1000001000000000110000001100001
111111111111111111111111111111111
