NO textures/NO.xpm
SO textures/SO.xpm
WE textures/WE.xpm
EA textures/EA.xpm

F 65,90,119
C 135,206,235

111111111111111111
100000000000000001
100000000000000001
100000000000000001
100000000000000001
1000000W0000000001
100000000000000001
100000000000000001
100000000000000001
111111111111111111
